1111111111111111111111111111111111
100000000000000C00000C000000000001
10100101001000001010010000C0010101
10100100101010100010010000P0010101
100000000C00C0100000000000E000000C1
1111111111111111111111111111111111