1111111111111111111111111111
100000000C00000C000000000001
1010100000101001000000010101
1010101010001001000000010101
100C00C00000P00000001E1000C1
1000000000000000000001000001
11100000011C1000000000001111
1000000000010000000000000001
1010100000101001000000010101
1010101010001001000000010101
10000C0000000000000000000001
1111111111111111111111111111
