11111111111111111111111111111111111
100000000000000C00000C0000000000011
10100101001000001110010000C00101011
10100100101010100110010000P00101011
100000000C00C0100000000000E00000C01
11111111111111111111111111111111111
